1111111111
1CE0E00001
1111111111
